Pronađi sve tragove koje ti je mama ostavila i obavi potrebne zadatke kako bi ti dozvolila da ideš kod prijatelja. Ne zaboravi, igrat ćete igrice pa moraš ponijeti i jednu svoju.

The Game
An Interactive Fiction by Valentina Tucelj
Release 1 / Serial number 230203 / Inform 7 v10.1.2 / D

Tvoja soba
11 je sati, još samo 3 sata dijele te od druženja s prijateljima. Tvoja stara Nokia je negdje na radnom stolu ispod hrpe razbacane odjeće.  Kupaonica je sjeverno od hodnika koji je sjeverno od tvoje sobe.

Velika vrećica je u kutu jer ti možeš nositi samo 4 stvari odjednom.

Ormar je prepun robe, no ima još nešto mjesta u njemu.

Prljava majica je na radnom stolu.

Hlače su na radnom stolu.

Prljava potkošulja je na radnom stolu.

Jakna je na radnom stolu.

Pulover je na radnom stolu.

Mobitel ti je zazvonio. Izgleda da ti je stigla poruka. Bilo bi dobro da je pročitaš, ali najprije se moraš nekako riješiti hrpe robe koja je na njemu.

I beg your pardon?

>idi sjeverno
Prljavu majicu moraš nositi na pranje u Kupaonicu koja je sjeverno od hodnika.

>uzmi majicu
majica - Uzeto!

>idi sjeverno
Potkošulja je prljava i treba ju odnijeti na pranje u kupaonicu koja je sjeverno od hodnika.

* * *

>examine radni stol
On the radni stol are a majica, a hlace, a potkosulja, a jakna and a pulover.

* * *

>examine stolic
Na stolu su majica, hlače, potkošulja, jakna i pulover.

* * *

>go
You'll have to say which compass direction to go in.

>tkae
That's not a verb I recognize.

* * *

>idi sjeverno
Prljavu majicu moraš nositi na pranje u Kupaonicu koja je sjeverno od hodnika.

* * *

>idi sjeverno
Potkošulja je prljava i treba ju odnijeti na pranje u kupaonicu koja je sjeverno od hodnika.

>uzmi potkosulju
potkosulja - Uzeto!

>idi sjeverno
Hodnik

* * *

>pregledaj
(the velika vrecica)
The velika vrecica is empty.

* * *

>pregledaj stol
a majica, a hlace, a potkosulja, a jakna, a pulover and a mobitel

>uzmi jaknu
jakna - Uzeto!

* * *

>pregledaj stolic
a majica, a hlace, a potkosulja, a jakna, a pulover and a mobitel

>uzmi hlace
Taken.

>pregledaj stolic
a majica, a potkosulja, a jakna, a pulover and a mobitel

>take majica
Taken.

>take velika vrecica
Taken.

>inventory
You are carrying:
  a velika vrecica (open but empty)
  a majica
  a hlace

* * *

>procitaj poruku
Ne možeš do mobitela jer je majica na stolu. Makni svu odjeću najprije.
Ne možeš do mobitela jer su hlače na stolu. Makni svu odjeću najprije.
Ne možeš do mobitela jer je potkošulja na stolu. Makni svu odjeću najprije.
Ne možeš do mobitela jer je jakna na stolu. Makni svu odjeću najprije.
Ne možeš do mobitela jer je pulover na stolu. Makni svu odjeću najprije.

>take jakna
Taken.

>take hlace
Taken.

>take potkosulja
Taken.

>take pulover
Taken.

>take majica
Taken.

>procitaj poruku
Nova poruka od MAMA: Prije druženja s prijateljima zadatke je potrebno obaviti, najbolje da kreneš od svoje sobe i prljavu robu odneseš na pranje, a čistu spremiš u ormar.

* * *

>put hlace in the ormar
(first taking the hlace)
hlace - Uzeto!

hlace su sad u ormaru

* * *

>put majica in ormar
Ne možeš staviti u ormar nešto što još nisi uzeo!
Majica je prljava. Treba na pranje.

(first taking the majica)
majica - Uzeto!

majica je sad u ormaru.

* * *

>put majica in the ormar
Ne možeš staviti u ormar nešto što još nisi uzeo!

>take majica
majica - Uzeto!

>put majica in ormar
Majica je prljava. Treba na pranje.

>sto nosim
Ti nosiš:
majica,

>pregledaj stol
a hlace, a potkosulja, a jakna, a pulover and a mobitel

>uzmi hlace
hlace - Uzeto!

>uzmi potkosulju
potkosulja - Uzeto!

>uzmi jaknu
jakna - Uzeto!

>drop jaknu
Dropped.

>uzmi veliku vrecicu
velika vrecica - Uzeto!

>uzmi jaknu
(putting the majica into the velika vrecica to make room)
jakna - Uzeto!

>uzmi pulover
(putting the hlace into the velika vrecica to make room)
pulover - Uzeto!

>pregledaj stol
a mobitel

>sto nosim
Ti nosiš:
pulover, jakna, velika vrecica, potkosulja,

>pregledaj veliku vrecicu
In the velika vrecica are a hlace and a majica.

* * *

>take jakna
jakna - Uzeto!

>inventory
Ti nosiš:
a jakna

* * *

>take jakna
jakna - Uzeto!

>uzmia hlace
That's not a verb I recognize.

>uzmi hlace
hlace - Uzeto!

>sto nosim
Ti nosiš:
nothing

* * *

>take velika vrecica
velika vrecica - Uzeto!

>take majica
majica - Uzeto!

>take hlace
hlace - Uzeto!

>take jakna
You can't see any such thing.

>uzmi potkosulju
You can't see any such thing.

>take majica
You already have that.

>take pulover
You can't see any such thing.

>sto nosim
Ti nosiš:
hlace, majica, velika vrecica,

>pregledaj stolic
a potkosulja, a jakna, a pulover and a mobitel

>uzmi jaknu
You can't see any such thing.

>uzmi jakna
You can't see any such thing.

* * *

>idi zapadno
(first opening the plava vrata)
Bravo, tek je 11:59 am, a ti si već obavio sve zadatke.

>go west
You can't go that way.

* * *

>idi zapadno
(first opening the plava vrata)
Bravo, tek je 11:59 am, a ti si već obavio sve zadatke.

>unlock with tajni kljuc
You can't see any such thing.

>sto nosim
Ti nosiš:
tajni kljuc, mobitel, velika vrecica,

>unlock the plava vrata with the tajni kljuc
You unlock the plava vrata.

>idi zapadno
(first opening the plava vrata)

Predvorje

* * *

>otkljucaj plava vrata s tajnim kljucem
You unlock the plava vrata.

* * *

>otkljucaj plava vrata sa tajni kljuc
I didn't understand that sentence.

>otkljucaj plava vrata s tajni kljuc
You unlock the plava vrata.

* * *

>pitaj mamu o sljedecem zadatku
Dodaj mi stolčić.

>give stolcic to Mama
(first taking the stolcic)
stolcic - Uzeto!

Mama sad stoji na stolčiću da bude viša.

>pitaj mamu o sljedecem zadatku
Dodaj mi knjigu s receptima.

>give knjigu to Mama
(first taking the knjiga)
knjiga - Uzeto!

Mama sad ima svoju knjigu s receptima!

>pitaj mamu o sljedecem zadatku
Kosilica je u garaži koja je istočno, treba pokositi travu!

>sto nosim
Ti nosiš:
mobitel, velika vrecica,

>pregledaj vrecicu
Nemaš ništa u vrećici!

* * *

>pokosi travu
Mačka: Još uvijek nisi točno odgovorio na moje pitanje!

>9
Bravo. Točno si odgovorio na moje pitanje. Možeš nastaviti s košnjom.
That's not a verb I recognize.

>pokosi travu
Trebalo ti je 30 minuta da pokosiš dvorište.Tajni ključ sad je u tvojim rukama.

>sto nosim
Ti nosiš:
tajni kljuc, mobitel, velika vrecica,

* * *

>restart
Pronađi sve tragove koje ti je mama ostavila i obavi potrebne zadatke kako bi ti dozvolila da ideš kod prijatelja. Ne zaboravi, igrat ćete igrice pa moraš ponijeti i jednu svoju.

The Game
An Interactive Fiction by Valentina Tucelj
Release 1 / Serial number 230203 / Inform 7 v10.1.2 / D

Tvoja soba
11 je sati, još samo 3 sata dijele te od druženja s prijateljima. Tvoja stara Nokia je negdje na radnom stolu ispod hrpe razbacane odjeće.  Kupaonica je sjeverno od hodnika koji je sjeverno od tvoje sobe.

Velika vrećica je u kutu jer ti možeš nositi samo 4 stvari odjednom.

Ormar je prepun robe, no ima još nešto mjesta u njemu.

Prljava majica je na radnom stolu.

Hlače su na radnom stolu.

Prljava potkošulja je na radnom stolu.

Jakna je na radnom stolu.

Pulover je na radnom stolu.

Mobitel ti je zazvonio. Izgleda da ti je stigla poruka. Bilo bi dobro da je pročitaš, ali najprije se moraš nekako riješiti hrpe robe koja je na njemu.

>take
What do you want to take?

>uzmi majicu
What do you want to take?

>uzmi vrecicu
What do you want to take?

>take majicu
What do you want to take?

>majicu
What do you want to take?

* * *

>uzmi igrica
Izgleda da si obavio sve zadatke i da smiješ na igranje kod prijatelja. Igra je završena.

    *** The End ***

Would you like to RESTART, RESTORE a saved game, QUIT or UNDO the last command?

* * *

>uzmi kosilica
You can't see any such thing.

* * *

>uzmi kosilicu
Lozinka:

>TAJNA
Odlično! Kosilica je tvoja.Sada guraj kosilicu prema dvorištu!

>idi juzno
Dvoriste
Trava je stvarno visoka, ali možeš li istog trena početi s košnjom? Izgleda da se mačka neće samo tako maknuti.

Tajni ključ krije visoka trava. Kad je pokosiš možda ga nađeš.

Mačka: Maknut ću se samo ako mi odgovoriš točno na moje pitanje. Koliko života mačke imaju?

>pokosi dvoriste
Trebalo ti je 30 minuta da pokosiš dvorište.
That's not a verb I recognize.

>pokosi travu
Izgleda da je trava već pokošena!
That's not a verb I recognize.

* * *

>idi juzno
Dvoriste
Trava je stvarno visoka, ali možeš li istog trena početi s košnjom? Izgleda da se mačka neće samo tako maknuti.

Tajni ključ krije visoka trava. Kad je pokosiš možda ga nađeš.

Mačka: Maknut ću se samo ako mi odgovoriš točno na moje pitanje. Koliko života mačke imaju?

>pokosi travu
Mačka: Još uvijek nisi odgovorio na moje pitanje!

>pokosi dvoriste
Izgleda da je trava već pokošena!
That's not a verb I recognize.

>sto nosim
Ti nosiš:
tajni kljuc, mobitel, velika vrecica,

* * *

>uzmi kosilicu
Lozinka:

>idi juzno
Dvoriste
Trava je stvarno visoka, ali možeš li istog trena početi s košnjom?

Maknut ću se samo ako mi odgovoriš točno na moje pitanje. Koliko života mačke imaju?

* * *

>uzmi kosilicu
Lozinka:

>lozinka
Kriva lozinka!

>uzmi kosilicu
Lozinka:

>TAJNA
Odlično! Kosilica je tvoja.

>sto nosim
Ti nosiš:
kosilica, mobitel, velika vrecica,

>idi juzno
Dvoriste
Trava je stvarno visoka, ali možeš li istog trena početi s košnjom? Izgleda da se mačka neće samo tako maknuti.

Maknut ću se samo ako mi odgovoriš točno na moje pitanje. Koliko života mačke imaju?

>sto nosim
Ti nosiš:
kosilica, mobitel, velika vrecica,

* * *

>uzmo kosilicu
Mačka: Još uvijek niši odgovorio na moje pitanje!
That's not a verb I recognize.

* * *

>tkae
Provjeri da li je sve dobro napisano.

>tkae majica
Provjeri da li je sve dobro napisano.

>take majica
majica - Uzeto!

>take pullover
Provjeri da li je sve dobro napisano.

* * *

>uzmi jaknu
You can't see any such thing.

>pregledaj stol
a majica, a hlace, a potkosulja, a jakna, a pulover and a mobitel

* * *

>uzmi jaknu
You can't see any such thing.

>procitaj poruku
Ne možeš do mobitela jer je majica na stolu. Makni svu odjeću najprije.
Ne možeš do mobitela jer su hlače na stolu. Makni svu odjeću najprije.
Ne možeš do mobitela jer je potkošulja na stolu. Makni svu odjeću najprije.
Ne možeš do mobitela jer je pulover na stolu. Makni svu odjeću najprije.

* * *

>uzmi jaknu
You can't see any such thing.

>responses
>--> The following sets of responses are available:
    RESPONSES ALL
    RESPONSES 1: Standard Rules

* * *

>uzmi jaknu
You can't see any such thing.

>sto nosim
Ti nosiš:
jakna,

>uzmi hlace
hlace - Uzeto!

>sto nosim
Ti nosiš:
a hlace and a jakna

* * *

>sto nosim
Ti nosiš:
jakna,

>uzmi pulover
pulover - Uzeto!

>sto nosim
Ti nosiš:
pulover, jakna,

>uzmi majicu
majica - Uzeto!

>uzmi potkosulju
potkosulja - Uzeto!

>uzmi hlace
You're carrying too many things already.

>uzmi velika vrecica
You're carrying too many things already.

>drop hlace
You haven't got that.

>sto nosim
Ti nosiš:
potkosulja, majica, pulover, jakna,

>drop majica
Dropped.

>take velika vrecica
velika vrecica - Uzeto!

>take majica
(putting the jakna into the velika vrecica to make room)
majica - Uzeto!

>drop majica
Dropped.

>pregledaj stolic
a hlace and a mobitel

>examine
What do you want to examine?

>examine Tvoja soba
What do you want to examine?

>tvoja soba
What do you want to examine?

* * *

>uzmi jaknu
You can't see any such thing.

>uzmi jaknu
You can't see any such thing.

* * *

>uzmi majicu
majica - Uzeto!

>sto nosim
Ti nosiš:
majica,

>put majica on the radni stol
You put the majica on the radni stol.

>uzmi majicu
majica - Uzeto!

>put majica on radni stol
You put the majica on the radni stol.

* * *

>uzmi majicu
majica - Uzeto!

>uzmi veliku vrecicu
You can't see any such thing.

* * *

>uzmi majicu
majica - Uzeto!

>uzmi vrecicu
velika vrecica - Uzeto!

>uzmi jaknu
jakna - Uzeto!

>uzmi hlace
hlace - Uzeto!

>uzmi pulover
(putting the majica into the velika vrecica to make room)
majica je sada u velikoj vrećici.

pulover - Uzeto!

>uzmi potkosulju
(putting the jakna into the velika vrecica to make room)
jakna je sada u velikoj vrećici.

potkosulja - Uzeto!

>uzmi mobitel
(putting the hlace into the velika vrecica to make room)
hlace je sada u velikoj vrećici.

Nova poruka od MAMA: Prije druženja s prijateljima zadatke je potrebno obaviti, najbolje da kreneš od svoje sobe i čistu spremiš u ormar, a prljavu robu odneseš na pranje.

>stavi pulover u ormar
pulover je sad u ormaru.

>sto nosim
Ti nosiš:
mobitel, potkosulja, velika vrecica,

>uzmi majicu iz vrecice
majica - Uzeto!

>stavi majicu u ormar
Majica je prljava. Treba na pranje.

>uzmi hlace iz vrecice
(putting the potkosulja into the velika vrecica to make room)
potkosulja je sada u velikoj vrećici.

hlace - Uzeto!

>stavi hlace u ormar
hlace su sad u ormaru

>uzmi hlace iz vrecice
Provjeri da li je sve dobro napisano.

>uzmi jaknu iz vrecice
jakna - Uzeto!

>stavi jaknu u ormar
jakna je sad u ormaru.

>idi sjeverno
Hodnik
Sjeverno vidiš kupaonicu, a istočno kuhinju. Ako nosiš prljavo rublje idi u kupaonicu, inače idi u kuhinju.

>idi juzno
Tvoja soba
Što si zaboravio u sobi?

Ormar je prepun robe, no ima još nešto mjesta u njemu.

>idi sjeverno
Hodnik
Sjeverno vidiš kupaonicu, a istočno kuhinju. Ako nosiš prljavo rublje idi u kupaonicu, inače idi u kuhinju.

>idi sjeverno
Kupaonica
U kutu vidiš veliku košaru za prljavo rublje.

>idi sjeverno
You can't go that way.

>idi juzno
Nisi ostavio majicu na pranje!

>idi juzno
Nisi ostavio majicu na pranje!

Provjeri da li je sve dobro napisano.

Provjeri da li je sve dobro napisano.

>idi juzno
Nisi ostavio majicu na pranje!

>uzmi majicu iz vrecice
Provjeri da li je sve dobro napisano.

>stavi majicu u kosaru
majica je sad u košari za pranje.

>uzmi potkosulju iz vrecice
potkosulja - Uzeto!

>stavi potkosulju u vrecicu
potkosulja je sada u velikoj vrećici.

>idi juzno
Nisi ostavio potkosulju na pranje!

>uzmi potkosulju iz vrecice
potkosulja - Uzeto!

>stavi potkosulju u kosaru
potkosulja je sad u košari za pranje.

>idi juzno
Hodnik
Sjeverno vidiš kupaonicu, a istočno kuhinju. Ako nosiš prljavo rublje idi u kupaonicu, inače idi u kuhinju.

>idi istocno
Kuhinja
U kuhinji je mama. Pitaj je za sljedeći zadatak..

Mama je niska i stoji kod velikog kuhinjskog stola.

Knjiga s receptima za kolače je na stolu.

Maleni stolčić je u kuhinji.

>pitaj mamu o sljedecem zadatku
Dodaj mi stolčić.

>daj stolcic mami
(first taking the stolcic)
stolcic - Uzeto!

Mama sad stoji na stolčiću da bude viša.

>pitaj mamu o sljedecem zadatku
Dodaj mi knjigu s receptima.

>daj knjigu mami
(first taking the knjiga)
knjiga - Uzeto!

Mama sad ima svoju knjigu s receptima!

>pitaj mamu o sljedecem zadatku
Kosilica je u garaži koja je istočno, treba pokositi travu! Nju čuva TAJNA.

>idi istocno
Garaza
Tamo južno u dvorištu vidiš da je već stvarno visoka trava.

Kosilica je nasred garaže.

>uzmi kosilicu
Lozinka:

>tajna
Odlično! Kosilica je tvoja.Sada guraj kosilicu prema dvorištu!

>idi juzno
Dvoriste
Vidiš plava vrata koja te vode zapadno u predvorje. Trava je stvarno visoka, ali možeš li istog trena početi s košnjom? Izgleda da se mačka neće samo tako maknuti.

Tajni ključ krije visoka trava. Kad je pokosiš možda ga nađeš.

Mačka: Maknut ću se samo ako mi odgovoriš točno na moje pitanje. Koliko života mačke imaju?

>pokosi travu
Mačka: Još uvijek nisi točno odgovorio na moje pitanje!

>9
Bravo. Točno si odgovorio na moje pitanje. Možeš nastaviti s košnjom.

>pokosi travu
Trebalo ti je 30 minuta da pokosiš dvorište.Tajni ključ sad je u tvojim rukama. Bilo bi dobro da odeš u predvorje po igricu.

>sto nosim
Ti nosiš:
tajni kljuc, mobitel, velika vrecica,

>otkljucaj plava vrata s tajnim kljucem
Otključao si plava vrata. Sada možeš zapadno u predvorje.

>otvori plava vrata
Otvorio si plava vrata!

>idi zapadno
Predvorje
Trenutno je 2:03 pm sati.

Tvoja omiljena igrica je spremna za druženje s prijateljima.

>uzmi igricu
Izgleda da nisi stigao sve obaviti na vrijeme da bi išao kod prijatelja

    *** The End ***

Would you like to RESTART, RESTORE a saved game, QUIT or UNDO the last command?

* * *

>uzmi veliku vrecicu
velika vrecica - Uzeto!

>pregledaj vrecicu
You can't see any such thing.

>pregledaj veliku vrecicu
Još nemaš ništa u vrecici!

>uzmi jaknu
jakna - Uzeto!

>uzmi majicu
majica - Uzeto!

>uzmi hlace
hlace - Uzeto!

>uzmi pulover
(putting the jakna into the velika vrecica to make room)
pulover - Uzeto!

* * *

>uzmi veliku vrecicu
velika vrecica - Uzeto!

>uzmi jaknu
jakna - Uzeto!

* * *

>uzmi hlace
hlace - Uzeto!

>uzmi potkosulju
(putting the jakna into the velika vrecica to make room)
potkosulja - Uzeto!

>uzmi pulover
(putting the majica into the velika vrecica to make room)
pulover - Uzeto!

>pregledaj stol
a mobitel

>procitaj poruku
(putting the hlace into the velika vrecica to make room)
Nova poruka od MAMA: Prije druženja s prijateljima zadatke je potrebno obaviti, najbolje da kreneš od svoje sobe i prljavu robu odneseš na pranje, a čistu spremiš u ormar.

>put hlace in the ormar
(first taking the hlace)
(putting the potkosulja into the velika vrecica to make room)
hlace - Uzeto!

hlace je sad u ormaru.

* * *

>pregledaj stol
a mobitel

>sto nosim
Ti nosiš:
pulover, potkosulja, hlace, velika vrecica,

>pregledaj veliku vrecicu
U velikoj vrecicu su: a majica and a jakna

* * *

>uzmi veliku vrecicu
velika vrecica - Uzeto!

>uzmi majicu
majica - Uzeto!

* * *

>uzmi hlace
hlace - Uzeto!

>pregledaj stol
Na stolu su:  potkosulja, jakna, pulover, mobitel,

>pregledaj veliku vrecicu
U velikoj vrecicu su:

>uzmi potkosulju
potkosulja - Uzeto!

>uzmi jaknu
(putting the majica into the velika vrecica to make room)
jakna - Uzeto!

* * *

>uzmi pulover
(putting the hlace into the velika vrecica to make room)
pulover - Uzeto!

>pregledaj veliku vrecicu
U velikoj vrecicu su:  hlace, majica,

* * *

>uzmi potkosulju
potkosulja - Uzeto!

>uzmi jaknu
(putting the majica into the velika vrecica to make room)
majica je sada u velikoj vrećici.

jakna - Uzeto!

>uzmi pulover
(putting the hlace into the velika vrecica to make room)
hlace je sada u velikoj vrećici.

pulover - Uzeto!

>pregledaj stol
Na stolu su:  mobitel,

>procitaj poruki
That's not a verb I recognize.

>procitaj poruku
(putting the potkosulja into the velika vrecica to make room)
mobitel - Uzeto!

* * *

>pregledaj stol
Na stolu su:  mobitel,

>procitaj poruku
(putting the potkosulja into the velika vrecica to make room)
potkosulja je sada u velikoj vrećici.

Nova poruka od MAMA: Prije druženja s prijateljima zadatke je potrebno obaviti, najbolje da kreneš od svoje sobe i čistu spremiš u ormar, a prljavu robu odneseš na pranje.

>idi sjeverno
Prljavu majicu moraš nositi na pranje u Kupaonicu koja je sjeverno od hodnika.

* * *

>uzmi majicu
majica - Uzeto!

>uzmi jaknu
jakna - Uzeto!

* * *

>uzmi hlace
hlace - Uzeto!

>uzmi potkosulju
(putting the majica into the velika vrecica to make room)
potkosulja - Uzeto!

>uzmi pulover
(putting the jakna into the velika vrecica to make room)
pulover - Uzeto!

>pregledaj stol
a mobitel

>procitaj poruku
Nova poruka od MAMA: Prije druženja s prijateljima zadatke je potrebno obaviti, najbolje da kreneš od svoje sobe i prljavu robu odneseš na pranje, a čistu spremiš u ormar.

(putting the hlace into the velika vrecica to make room)
mobitel - Uzeto!

* * *

>uzmi potkosulju
potkosulja - Uzeto!

>go east
You can't go that way.

>idi sjeverno
Nisi pročitao poruku na mobitelu.

>uzmi hlace
hlace - Uzeto!

>uzmi jaknu
(putting the majica into the velika vrecica to make room)
majica je sada u velikoj vrećici.

jakna - Uzeto!

>uzmi pulover
(putting the potkosulja into the velika vrecica to make room)
potkosulja je sada u velikoj vrećici.

pulover - Uzeto!

>pregledaj stol
Na stolu su:  mobitel,

>procitaj poruku
(putting the hlace into the velika vrecica to make room)
hlace je sada u velikoj vrećici.

Nova poruka od MAMA: Prije druženja s prijateljima zadatke je potrebno obaviti, najbolje da kreneš od svoje sobe i prljavu robu odneseš na pranje, a čistu spremiš u ormar.

>idi sjeverno
Prljavu majicu moraš nositi na pranje u Kupaonicu koja je sjeverno od hodnika.

* * *

>uzmi vrecicu
velika vrecica - Uzeto!

>uzmi hlace
hlace - Uzeto!

>stavi hlace u ormar
hlace su sad u ormaru

>uzmi jaknu
jakna - Uzeto!

>stavi jaknu u ormar
jakna je sad u ormaru.

>uzmi majicu
majica - Uzeto!

>stavi majicu u ormar
Majica je prljava. Treba na pranje.

>uzmi potkosulju
potkosulja - Uzeto!

>uzmi pulover
pulover - Uzeto!

>procitaj poruku
(putting the majica into the velika vrecica to make room)
majica je sada u velikoj vrećici.

Nova poruka od MAMA: Prije druženja s prijateljima zadatke je potrebno obaviti, najbolje da kreneš od svoje sobe i čistu spremiš u ormar, a prljavu robu odneseš na pranje.

>idi sjeverno
Nisi pospremio pulover u ormar.

>stavi pulover u ormar
pulover je sad u ormaru.

* * *

>sto nosim
Ti nosiš:
mobitel, potkosulja, velika vrecica,

>idi sjeverno
Hodnik

* * *

>uzmi vrecicu
velika vrecica - Uzeto!

>uzmi majicu
majica - Uzeto!

* * *

>uzmi hlace
hlace - Uzeto!

>uzmi jaknu
jakna - Uzeto!

>uzmi potkosulju
(putting the majica into the velika vrecica to make room)
majica je sada u velikoj vrećici.

potkosulja - Uzeto!

>uzmi pulover
(putting the hlace into the velika vrecica to make room)
hlace je sada u velikoj vrećici.

pulover - Uzeto!

>procitaj poruku
(putting the jakna into the velika vrecica to make room)
jakna je sada u velikoj vrećici.

Nova poruka od MAMA: Prije druženja s prijateljima zadatke je potrebno obaviti, najbolje da kreneš od svoje sobe i čistu spremiš u ormar, a prljavu robu odneseš na pranje.

>stavi pulover u ormar
pulover je sad u ormaru.

>stavi jaknu u orrmar
You can't see any such thing.

>stavi jaknu u ormar
Ne možeš staviti u ormar nešto što još nisi uzeo! Možda ti je u vrećici pa moraš prvo izvaditi.

>utmi jaknu iz vrecice
That's not a verb I recognize.

>uzmi jaknu iz vrecice
jakna - Uzeto!

* * *

>stavi jaknu u ormar
jakna je sad u ormaru.

>uzmi hlace iz vrecice
hlace - Uzeto!

>stavi hlace u ormar
hlace su sad u ormaru

>sto nosim
Ti nosiš:
mobitel, potkosulja, velika vrecica,

>pregledaj vrecicu
U velikoj vrećici su:  majica,

>idi sjeverno
Hodnik
Sjeverno vidiš kupaonicu, a istočno kuhinju. Ako nosiš prljavo rublje idi u kupaonicu, inače idi u kuhinju.

* * *

>idi sjeverno
Kupaonica
U kutu vidiš veliku košaru za prljavo rublje.

>stavi potkosulju u kosaru
potkosulja je sad u košari za pranje.

>uzmi majicu iz vrecice
majica - Uzeto!

>stavi majicu u kosaru
majica je sad u košari za pranje.

>uzmi majicu iz kosare
You can't see any such thing.

>uzmi majicu iz kosara
majica - Uzeto!

>idi juzno
Nisi ostavio majicu na pranje!

>stavi majicu u kosaru
majica je sad u košari za pranje.

>idi juzno
Hodnik
Sjeverno vidiš kupaonicu, a istočno kuhinju. Ako nosiš prljavo rublje idi u kupaonicu, inače idi u kuhinju.

>sto nosim
Ti nosiš:
mobitel, velika vrecica,

>pregledaj vrecicu
Još nemaš ništa u vrećici!

>idi istocno
Kuhinja

* * *

>uzmi jaknu
(putting the majica into the velika vrecica to make room)
majica je sada u velikoj vrećici.

jakna - Uzeto!

>uzmi oulover
You can't see any such thing.

>uzmi pulover
(putting the hlace into the velika vrecica to make room)
hlace je sada u velikoj vrećici.

pulover - Uzeto!

>procitaj poruku
(putting the potkosulja into the velika vrecica to make room)
potkosulja je sada u velikoj vrećici.

Nova poruka od MAMA: Prije druženja s prijateljima zadatke je potrebno obaviti, najbolje da kreneš od svoje sobe i čistu spremiš u ormar, a prljavu robu odneseš na pranje.

>stavi majicu u ormar
Majica je prljava. Treba na pranje.

>stavi pulover u ormar
Ne možeš staviti u ormar nešto što još nisi uzeo!

>sto nosim
Ti nosiš:
mobitel, pulover, jakna, velika vrecica,

>stavi jaknu u ormar
Ne možeš staviti u ormar nešto što još nisi uzeo!

* * *

>procitaj poruku
(putting the potkosulja into the velika vrecica to make room)
potkosulja je sada u velikoj vrećici.

Nova poruka od MAMA: Prije druženja s prijateljima zadatke je potrebno obaviti, najbolje da kreneš od svoje sobe i čistu spremiš u ormar, a prljavu robu odneseš na pranje.

>idi sjeverno
Nisi pospremio hlače u ormar.

>put hlace in ormar
Ne možeš staviti u ormar nešto što još nisi uzeo!

>put pulover in ormar
pulover je sad u ormaru.

>take hlace from velika vrecica
hlace - Uzeto!

>put hlace in ormar
hlace su sad u ormaru

>put jaknu in ormar
jakna je sad u ormaru.

>sto nosim
Ti nosiš:
mobitel, velika vrecica,

>idi sjeverno
Nisi pospremio pulover u ormar.

>pregledaj ormar
In the ormar are a jakna, a hlace and a pulover.

* * *

>idi sjeverno
Nisi pospremio hlače u ormar.

>sto nosim
Ti nosiš:
mobitel, pulover, jakna, velika vrecica,

* * *

>procitaj poruku
(putting the potkosulja into the velika vrecica to make room)
potkosulja je sada u velikoj vrećici.

Nova poruka od MAMA: Prije druženja s prijateljima zadatke je potrebno obaviti, najbolje da kreneš od svoje sobe i čistu spremiš u ormar, a prljavu robu odneseš na pranje.

>stavi jaknu u ormar
jakna je sad u ormaru.

>stavi pulover u ormar
pulover je sad u ormaru.

>sto nosim
Ti nosiš:
mobitel, velika vrecica,

>take hlace from vrecica
hlace - Uzeto!

>stavi hlace u ormar
hlace su sad u ormaru

>idi sjeverno
Hodnik
Sjeverno vidiš kupaonicu, a istočno kuhinju.

>idi juzno
Tvoja soba
Što si zaboravio u sobi?

Ormar je prepun robe, no ima još nešto mjesta u njemu.

* * *

>stavi pulover u ormar
pulover je sad u ormaru.

>uzmi hlace iz vrecice
hlace - Uzeto!

* * *

>stavi hlace u ormar
hlace su sad u ormaru

>idi sjeverno
Hodnik
Sjeverno vidiš kupaonicu, a istočno kuhinju. Ako nosiš prljavo rublje idi u kupaonicu, inače idi u kuhinju.

>idi sjeverno
Kupaonica
U kutu vidiš veliku košaru za prljavo rublje.

U kutu stoji košara za prljav veš.

>stavi majicu u kosaru
Ne možeš staviti u košaru nešto što nisi uzeo! Možda ti je u vrećici pa moraš prvo izvaditi.

>uzmi majicu iz vrecice
majica - Uzeto!

>stavi majicu u kosaru
To ne treba na pranje.

* * *

>procitaj poruku
(putting the potkosulja into the velika vrecica to make room)
potkosulja je sada u velikoj vrećici.

Nova poruka od MAMA: Prije druženja s prijateljima zadatke je potrebno obaviti, najbolje da kreneš od svoje sobe i čistu spremiš u ormar, a prljavu robu odneseš na pranje.

>stavi majicu u ormar
Ne možeš staviti u ormar nešto što još nisi uzeo!

>stavi potkosulju u ormar
Ne možeš staviti u ormar nešto što još nisi uzeo!

* * *

>procitaj poruku
(putting the potkosulja into the velika vrecica to make room)
potkosulja je sada u velikoj vrećici.

Nova poruka od MAMA: Prije druženja s prijateljima zadatke je potrebno obaviti, najbolje da kreneš od svoje sobe i čistu spremiš u ormar, a prljavu robu odneseš na pranje.

>stavi pulover u ormar
pulover je sad u ormaru.

>stavi jaknu u ormar
jakna je sad u ormaru.

* * *

>uzmi hlace iz vrecice
hlace - Uzeto!

>stavi hlace u oramr
You can't see any such thing.

>stavi hlace u ormar
hlace su sad u ormaru

* * *

>idi sjeverno
Kupaonica
U kutu vidiš veliku košaru za prljavo rublje.

>uzmi majicu iz vrecice
majica - Uzeto!

* * *

>stavi potkosulju u vrecicu
potkosulja je sada u velikoj vrećici.

>uzmi potkosulju iz vrecice
potkosulja - Uzeto!

* * *

>idi juzno
Hodnik
Sjeverno vidiš kupaonicu, a istočno kuhinju. Ako nosiš prljavo rublje idi u kupaonicu, inače idi u kuhinju.

>idi istocno
Kuhinja
U kuhinji je mama. Pitaj je za sljedeći zadatak..

Mama je niska i stoji kod velikog kuhinjskog stola.

Knjiga s receptima za kolače je na stolu.

You can also see a stolcic here.

>ask Mama about sljedeci zadatak
Dodaj mi stolčić..

>uzmi stolcic
stolcic - Uzeto!

>give stolcic to Mama
Mama doesn't seem interested.

* * *

>uzmi jaknu
jakna - Uzeto!

>uzmi potkosulju
potkosulja - Uzeto!

>uzmi hlace
(putting the majica into the velika vrecica to make room)
majica je sada u velikoj vrećici.

hlace - Uzeto!

>uzmi pulover
(putting the jakna into the velika vrecica to make room)
jakna je sada u velikoj vrećici.

pulover - Uzeto!

>procitaj poruku
(putting the potkosulja into the velika vrecica to make room)
potkosulja je sada u velikoj vrećici.

Nova poruka od MAMA: Prije druženja s prijateljima zadatke je potrebno obaviti, najbolje da kreneš od svoje sobe i čistu spremiš u ormar, a prljavu robu odneseš na pranje.

* * *

>stavi pulover u ormar
pulover je sad u ormaru.

>stavi jaknu u ormar
Ne možeš staviti u ormar nešto što još nisi uzeo!Možda ti je u vrećici pa moraš prvo izvaditi.

>uzmi jaknu iz vrecice
You can't see any such thing.

>uzmi jaknu iz vrecicu
jakna - Uzeto!

>stavi jaknu u ormar
jakna je sad u ormaru.

>sto nosim
Ti nosiš:
mobitel, hlace, velika vrecica,

>stavi hlace u ormar
hlace su sad u ormaru

* * *

>idi sjeverno
Hodnik
Sjeverno vidiš kupaonicu, a istočno kuhinju. Ako nosiš prljavo rublje idi u kupaonicu, inače idi u kuhinju.

>drop vrecicu
Dropped.

>idi juzno
Ne možeš natrag u sobu!

>uzmi vrecicu
velika vrecica - Uzeto!

>pregledaj vrecicu
U velikoj vrećici su:  potkosulja, majica,

* * *

>uzmi potkosulju
potkosulja - Uzeto!

>uzmi hlace
hlace - Uzeto!

* * *

>uzmi pulover
(putting the majica into the velika vrecica to make room)
majica je sada u velikoj vrećici.

pulover - Uzeto!

>uzmi jaknu
(putting the potkosulja into the velika vrecica to make room)
potkosulja je sada u velikoj vrećici.

jakna - Uzeto!

>procitaj poruku
(putting the hlace into the velika vrecica to make room)
hlace je sada u velikoj vrećici.

Nova poruka od MAMA: Prije druženja s prijateljima zadatke je potrebno obaviti, najbolje da kreneš od svoje sobe i čistu spremiš u ormar, a prljavu robu odneseš na pranje.

>idi sjeverno
Potkošulja je prljava i treba ju odnijeti na pranje u kupaonicu koja je sjeverno od hodnika.

* * *

>uzmi majicu
majica - Uzeto!

>uzmi pulover
pulover - Uzeto!

>uzmi hlace
hlace - Uzeto!

>uzmi jaknu
(putting the majica into the velika vrecica to make room)
majica je sada u velikoj vrecici.

jakna - Uzeto!